# DisplayFK core library

DisplayFK	KEYWORD1
loadWidgets	KEYWORD2
drawWidgetsOnScreen	KEYWORD2
createTask	KEYWORD2
updateRotation	KEYWORD2
checkCalibration	KEYWORD2
recalibrate	KEYWORD2
changeWTD	KEYWORD2
setupSD	KEYWORD2
startTransaction	KEYWORD2
finishTransaction	KEYWORD2
loadScreen	KEYWORD2

setCheckbox	KEYWORD2
setCircleButton	KEYWORD2
setGauge	KEYWORD2
setHSlider	KEYWORD2
setLabel	KEYWORD2
setLed	KEYWORD2
setLineChart	KEYWORD2
setNumberbox	KEYWORD2
setupNumpad	KEYWORD2
setRadioGroup	KEYWORD2
setRectButton	KEYWORD2
setTextbox	KEYWORD2
setupKeyboard	KEYWORD2
setToggle	KEYWORD2
setTouchArea	KEYWORD2
setVAnalog	KEYWORD2
setVBar	KEYWORD2
setImage	KEYWORD2
setCircularBar	KEYWORD2

CoordPoint_t	KEYWORD1
WidgetBase	KEYWORD1
detectTouch	KEYWORD2
getCallbackFunc	KEYWORD2
redraw	KEYWORD2
setValue	KEYWORD2
getValue	KEYWORD2
forceUpdate	KEYWORD2
setup	KEYWORD2
drawBackground	KEYWORD2
getStatus	KEYWORD2
changeState	KEYWORD2
getSelected	KEYWORD2
getGroupId	KEYWORD2
setSelected	KEYWORD2
getValueChar	KEYWORD2
convertoToChar	KEYWORD2
addValue	KEYWORD2
addMainValue	KEYWORD2
addSecondValue	KEYWORD2
addTwoValues	KEYWORD2
setLineColor	KEYWORD2
setGridColor	KEYWORD2
setBorderColor	KEYWORD2
setState	KEYWORD2
setText	KEYWORD2
setTextInt	KEYWORD2
setTextFloat	KEYWORD2
addLetter	KEYWORD2
removeLetter	KEYWORD2
open	KEYWORD2
close	KEYWORD2
clear	KEYWORD2
addChar	KEYWORD2
removeLastChar	KEYWORD2
countChars	KEYWORD2
setString	KEYWORD2
getString	KEYWORD2
substring	KEYWORD2
toInt	KEYWORD2
toFloat	KEYWORD2
containsChar	KEYWORD2
drawWidgets	KEYWORD2

radio_t	KEYWORD1
VBar	KEYWORD1
VAnalog	KEYWORD1
TouchArea	KEYWORD1
ToggleButton	KEYWORD1
TextBox	KEYWORD1
RectButton	KEYWORD1
RadioGroup	KEYWORD1
NumberBox	KEYWORD1
LineChart	KEYWORD1
Led	KEYWORD1
Label	KEYWORD1
WKeyboard	KEYWORD1
PressedKeyType	KEYWORD1
KeyboardType	KEYWORD1
HSlider	KEYWORD1
GaugeSuper	KEYWORD1
CircleButton	KEYWORD1
CheckBox	KEYWORD1
CharString	KEYWORD1
Image	KEYWORD1
CircularBar	KEYWORD1